note: the invite is only for Ian Osborne and is not transferable as we are limited to only 150 participants. There are no
sponsors. We increase the retreat fee weekly to reward the people that sign up early. And this retreat is 100% off-the-
record.

We hope you can join us.

Dialog participants...

... partial list of people who will be participating in the 2013 Dialog Retreat (all are references):

Veronica Allende Serra — Founding Partner, Pacific Investments. Chm, Portal de Documentos. Boards: Allied Advanced Technologies, Wow! Nutrition,
Mercado Libre, ISmart Foundation.

Susan Athey -- Professor of Economics, Harvard University. Chief Economist, Microsoft. 2007 Winner of John Bates. Clark Medal.

Byron Auguste -- Director and Head of Social Sector Office, McKinsey & Co. Chm, Hope Street Group. Boards: William and Flora Hewlett Foundation;
Pacific Council on International Policy; Center for American Progress.

David Barron — Professor, Harvard Law School. Fmr Acting Asst U.S. Attorney General in the Office of Legal Counsel.
Kirsten Bartok -- CEO, AirFinance. Fmr CFO of XOJet. Fmr GP at Alpine Investors.

Evan Bayh -— Sr Advisor, Apollo Management. Partner, McGuireWoods. Fmr U.S. Senator (D-IN) (1999-2011). Fmr Governor of Indiana (1989-
1997). Author, From Father to Son.

Tom Bedecarre — CEO, AKQA.

Nick Beim — GP, Matrix. Boards: Gilt Groupe, TheLadders, Care.com, Conductor, Intent Media, BuyWithMe.
Nicolas Berggruen -- President, Berggruen Holdings.

Charles Best — CEO, DononrsChoose.

Elizabeth Blackburn — Prof of Biology and Physiology, UCSF. 2009 Winner of Nobel Prize in Medicine. President, American Association of Cancer
Research.

David Bonderman — Founding Partner, Texas Pacific Group (TPG). Founding Partner, Newbridge Capital. Boards: Continental Airlines, Bowe Bell &
Howell, Ducati Motorcycles, Credicom Asia, National Education Corp, Beringer Wine, Carr Reality, Virgin Cinemas, CoStar Group, GemAlto, RyandAir
Holdings, Wilderness Society, World Wildlife Fund.

Jason Bordoff — Senior Advisor for Energy and Environmental Policy to U.S. President Obama.

Erik Brynjolfsson — Prof of Economics, MIT Sloan School of Management. Director, MIT Center for Digital Business. Chair, 77 Sloan Management
Review. Author, Race Against the Machine.

John Burbank — CEO, Passport Capital.

John Burbank — President, Nielsen Strategic Initiatives. Fmr CEO of Online, Nielsen. Fmr CMO, Nielsen. Fmr CMO, AOL.
Leah Busque - Founder, TaskRabbit.

Marc Cenedella — CEO, TheLadders.

Stephen Cohen -— cofounder, Palantir.

Gio Colella — CEO, Castlight Health. Fmr CEO, RelayHealth.

Mark Colodny — Managing Director, Warburg Pincus. Boards: CAMP Systems, GlobalSpec, MLM Information, iParadigms, MultiView, A Place for Mom,
EVIDON, eCert, Spigit, OnTargetJobs.

Boykin Curry -- Managing Director, Eagle Capital. Creator of Playa Grande. Cofndr, Girls Prep. Boards: Alliance for School Choice, Democrats for
Education Reform.

Adam D’Angelo - CEO, Quora. Fmr CTO, Facebook.

Mitch Daniels — President, Purdue University. Governor, State of Indiana (2005-2013). Fmr Director, Office of Management and Budget (2001-
2003).

Lanny Davis -- Fmr Special Counsel to the President (under Clinton). Author of Scandal and The Emerging Democratic Majority.

Ken Denman - CEO, Machine Perception Technologies. Fmr CEO of Openwave. Fmr CEO
of iPass (IPAS). Fmr CEO, AuraServ Communications. Fmr SVP MediaOne. National Markets.

Marc Ecko — Chief Creative Officer, Marc Ecko Enterprises. Award-winning artist.

RP Eddy — CEO, Ergo. Fmr Director, White House National Security Council. Fmr Chief of Staff to U.N. Ambassador Richard Holbrooke. Sr Fellow,
Manhattan Institute.

Juan Enriquez — CEO, Biotechonomy. Founding Director of the Life Sciences Project, Harvard Business School. Boards: Cabot Corp, Craig Venter
Institute. Fmr CEO, Mexico City ‘s Urban Development Corporation.

Jeff Epstein — fmr CFO, Oracle. Fmr CFO, DoubleClick. Fmr CFO, King World Productions. Boards: Priceline.com, Stanford University Hospital.

Niall Ferguson — Prof History, Harvard. Author of 7he World’s Banker: The History of the House of Rothschild, The Cash Nexus, Empire, Colossus, The
War of the World, The Ascent of Money, and others.

HOUSE_OVERSIGHT_013485
