Appendix A
Glossary

A.1 List of Specialized Acronyms

This includes acronyms that are commonly used in discussing CogPrime, OpenCog and related
ideas, plus some that occur here and there in the text for relatively ephemeral reasons.

AA: Attention Allocation

ADF: Automatically Defined Function (in the context of Genetic Programming)
AF: Attentional Focus

AGI: Artificial General Intelligence

AV: Attention Value

BD: Behavior Description

C-space: Configuration Space

CBV: Coherent Blended Volition

CEV: Coherent Extrapolated Volition

CGGP: Contextually Guided Greedy Parsing

CSDLN: Compositional Spatiotemporal Deep Learning Network
CT: Combo Tree

ECAN: Economic Attention Network

ECP: Embodied Communication Prior

EPW : Experiential Possible Worlds (semantics)

FCA: Formal Concept Analysis

FI : Fisher Information

FIM: Frequent Itemset Mining

FOI: First Order Inference

FOPL: First Order Predicate Logic

FOPLN: First Order PLN

FS-MOSES: Feature Selection MOSES (i.e. MOSES with feature selection integrated a la
LIFES)

GA: Genetic Algorithms

325

HOUSE_OVERSIGHT_013241
