Brad Garlinghouse — CEO, YouSendIt.

Julius Genachowski — Chairman, Federal Communications Commission (FCC).

Jared Genser — MD, Persesus Strategies. Founder, Freedom Now. International lawyer for Aung San Suu Kyi.
Jeff George — Global Head, Sandoz. Member of Exec Committee, Novartis.

Dave Goldberg — CEO, SurveyMonkey.

Tom Goldstein -- Partner, Goldstein & Howe. Fmr Partner and head of Supreme Court practice, Akin Gump. Has argued over 20 cases before Supreme
Court. CEO, SCOTUSblog.

Fabrice Grinda -- CEO, OLX. Fmr fndr and CEO, Zingy. Fmr CEO, Aucland.
Ash Gupta — Chief Risk Officer, American Express.

Richard Haass — President, Council on Foreign Relations. Fmr Director of Policy Planning, U.S. State Department. Fmr U.S. Special Envoy to Northern
Ireland.

Victor Halberstadt — Prof of Economics, Leiden University (Netherlands). Fmr President, International Institute of Public Finance. Mbr, Investment
Committee, ABP Pension Fund. Boards: RHJ Internationall.

Janet Hanson — CEO, 85Broads.
Hollie Moore Haynes — MD, Silver Lake Partners.

Bob Hertzberg -- Chairman, G24 Innovations. Partner, Mayer Brown Rowe & Maw. Fmr Speaker, California State Assembly (2000-2002). Fmr Regent,
University of California. Fmr Chm, Mayor Antonio Villaraigosa transition team. Board: Solar Integrated Technologies (Chm), California Historical Society,
MALDEF, Town Hall Los Angeles, Century Housing.

Jim Himes — U.S. Congressman (D-CT).

Auren Hoffman -- CEO of LiveRamp. Chm, Rapleaf. Curator, Dialog Retreat. Board: Retargeter.

Reid Hoffman — Chairman and founder, LinkedIn. Partner, Greylock. Boards: DoSomething, Kiva, Endeavor Global, Mozilla. Zynga.
Jacob Hsu - CEO, Symbio.

Daisuke Iwase — cofounder and COO, Lifenet Insurance (top life insurance company in Japan).

Christian Johansson -— Secretary of Department of Business and Economic Development (DBED), State of Maryland. Fmr CEO, Economic Alliance of
Greater Baltimore.

David Kamenetzky — Group Head, Mars & Co.
PV Kannan - CEO, 24/7 Customer.

Andy Karsner - CEO, Manifest Energy. Fmr U.S. Asst Sec of Energy for Energy Efficiency and Renewable Energy (2005-2009). Fmr Managing
Director, Enercorp. Boards: Applied Materials, Conservation International.

Garry Kasporov — Fmr World Chess Champion. Chm, United Civil Front of Russia.

Neal Katyal — Partner, Hogan Lovells. Fmr Acting Solicitor General for the United States (2010-2011). Professor of Law, Georgetown U. Lead counsel
for the plaintiff in Supreme Court case Hamdan vs. Rumsfeld.

Terry Kawaja — CEO, Luma Partners.

Juliette Kayyem - Foreign Affairs Columnist, Boston Globe. Lecturer in Public Policy, Harvard. Asst Sec. for Intergovernmental Affairs, U.S. Dept. of
Homeland Security.

Jeff Kearl — Chm, SkullCandy.
Peter Kellner -- MD, Richmond Management. Cofounder, Endeavor. Fmr partner, Vectis Group.
Chris Kelly -- Fmr Chief Privacy Officer and Head of Global Public Policy at Facebook . Fmr Chief Privacy Office, Excite@Home.

Pradeep Khosla — Chancellor, UC San Diego. Fmr Dean of College of Engineering, Carnegie Mellon. Boards: Quantpoint, BioMatricore, BitArmor,
Children’s Institute, IIT Foundation, Mellon-Pitt Corp.

Charlie Kim — CEO, NextJump.
David Kirkpatrick — Author, 7he Facebook Effect. Fmr head technology writer, FORTUNE.

Henry Kravis — Co-CEO of KKR. Chm, First Data. Boards: Claremont McKenna College, Metropolitan Museum of Art, Mount Sinai Medical Center,
Council on Foreign Relations, Columbia Business School, Rockefeller University, others. Fmr Chair, Partnership for New York City.

Marie-Josee Kravis — Boards: Publicis, LVMH. Boards: Memorial Sloan-Kettering Cancer Center, Robin Hood Foundation, Council on Foreign Relations,
Qatar Museum Authority. President, Museum of Modern Art board of directors. Fmr Board: Ford, IAC, CIBC.

Will Lansing — CEO, FICO (NYSE: FICO). Fmr CEO, InfoSpace. Fmr CEO, NBC Internet. Fmr COO, Prodigy Communications.
Renaud Laplanche — CEO, Lending Club.

Laura and Gary Lauder -- General Partners, Lauder Partners. Cofndrs, Socrates Society.

Jenna Lee — Anchor, Fox News. Host, Happening Now on Fox News.

Jorge Lemann — Fmr Owner, AmBev (largest brewery in Latin America) and now one of the largest shareholders in Anheuser-Busch InBev. Boards:
Lojas Americanas, Gillette, Swiss Re, Burger King.

Max Levchin — fmr CEO, Slide. Fmr co-founder, PayPal.

HOUSE_OVERSIGHT_013486
