Jonathan Levin — Prof and Chair of Dept of Economics, Stanford. 2011 Winner of the John Bates Clark Medal.
Ann Lewis - President, NoLimits. Fmr Director of Communications to the U.S. President (1997-2000).
Rob LoCasio — CEO, LivePerson (NASDAQ: LSPN).

Jeremy Liew — GP, LightSpeed Venture Partners. Investor in: Bonobos, CarDomain, Flixster,
Focus, Kixeye, Kongregate, LivingSocial, Playdom, RockYou, ShoeDazzle, and others.

Joe Lonsdale — CEO, Adepar. cofounder, Palantir.
Doreen Lorenzo — President, Frog Design.

Bob Luskin -- Partner and Co-Chair of Litigation Dept, Patton Boggs. Attorney to Karl Rove and Lance Armstrong. Fmr Chief Counsel to the Organized
Crime & Racketeering Section of DOJ.

Jorn Lyseggen — CEO of Meltwater.

John Maeda - President, Rhode Island School of Design. Author, Laws of Simplicity.

Divesh Makan — CEO, Iconiq Capital.

Meyer Malka — co-CEO, Lemon.

Andy McAfee — Principal Research Scientist at the Center for Digital Business, MIT. Author of Race Against the Machine.

General Stan McChrystal — Ret. 4-star U.S. General. Led all U.S. forces in Afghanistan. Fmr Commander, Joint Special Operations
Command. Current Principal, McChrystal Group. Sr. Fellow, Yale’s Jackson Institute for Global Affairs.

Andrew McLaughlin — Fmr VP, Tumblr. Fmr Deputy CTO of the United States, White House. Fmr Dir of Public Policy, Google. Boards: Public
Knowledge, Code for America.

Dmitri Mehlhorn — COO, StudentsFirst.

Lenny Mendonca -- Director, McKinsey. Head of McKinsey’s strategy practice. Chm, McKinsey Global Institute. Chm, Bay Area Council. Board:
McKinsey & Co, Economic Institute of the Bay Area, Bay Area Science and Innovation Consortium, The New America Foundation, Common Cause,
Committee for Economic Development, ChildrenNow, and DonorsChoose.

Eugene Meyer — President, Federalist Society.

Chris Michel — GP, Nautilus Ventures. Award-winning photographer. Fmr CEO, Affinity Labs. Fmr CEO, Military.com. Boards: International Data
Group, Dale Carnegie, Kixeye, Castlight Health, USO, Marine Corps University Foundation.

Katie Mitic — Fmr Head of Platform Marketing, Facebook. Fmr SVP, Palm. Fmr VP Product Strategy, Yahoo! Fmr Fndr and CEO, Four11. Boards:
eBay, Special Olympics International.

Wes Moore -- Author, “The Other Wes Moore”. Fmr. Special Assistant to Secretary of State Rice. Fmr Director of Information Operations, 82nd Airborne
Division, US Army, Afghanistan 2005-2006.

Nader Mousavizadeh — CEO of Oxford Analytica.

Luke Muehlhauser — Exec Director, Singularity University.

Matt Mullenweg — Founder, Wordpress.

Roger Myerson -- Prof of Economics, U of Chicago. 2007 winner of Nobel Prize in Economics.
Scott Nathan - Partner, Baupost Group.

Meghan O'Sullivan -- Professor, Harvard Kennedy School of Govt. Fmr Deputy National Security Advisor for Iraq and Afghanistan, President George
W. Bush. Mbr, Trilateral Commission.

Chamath Palihapitiya — CEO, Social+Capital. fmr VP Growth, Mobile, and International at Facebook. Fmr GM of AIM at AOL. Boards: SecondMarket,
FixYa, Lemon, Integrated Plasmonics. Co-Owner, Golden State Warriors.

Eli Pariser — Fmr President, MoveOn. Cofndr, Avaaz.org. Boards: MoveOn, Avaaz, New Organizing Institute and Simon’s Rock College.

Mark Penn — Corp VP of Strategic Projects (reports to the CEO), Microsoft. Fmr CEO, Burson-Marsteller. President, of polling firm Penn, Schoen
and Berland Associates. Fmr Chief Strategist, Hillary Clinton for President 2008. Author, Microtrends. Fmr pollster to President Clinton. Fmr pollster to
Prime Minister Tony Blair.

Lois Quam — Executive Director, Global Health Initiative — part of the State Department and she reports directly to Secretary Clinton. Fmr CEO of Public
and Senior Markets, UnitedHealth Group ($30 billion division).

Dan Rosensweig — CEO, Chegg. Fmr CEO, Guitar Hero. Fmr COO, Yahoo.

Robert Rubin — Co-Chairman, Council on Foreign Relations. Fmr U.S. Secretary of the Treasury (1995-1999). Fmr Director, National Economic Council
(1993-1995). Chm, Local Initiatives Support Corporation (LISC). Fmr Co-Chairman, Goldman Sachs.

Sal Russo — Founder, Tea Party Express. Partner, Russo Marsh.

Tod Sacerdoti — CEO, BrightRoll. Board: ReTargeter.

Amy Salzhauer - CEO, Ignition.

Cami Samuels - General Partner, Versant Ventures. Boards: Achaogen, APT Pharmaceuticals, Kythera Biopharmaceuticals, Semprae Laboratories.

Ken Sawyer -- CEO, Saints Ventures (manages over $1 billion in capital). Selected to Forbes Midas List. Boards: Continuous Computing, HK
Systems, Cleargauge, Travel Intelligence, Envivio, Alliance Consulting, Acsis and Laureate Pharmaceuticals.

Jessica Schell — EVP BD and Strategic Planning, Universal Pictures. Fmr SVP Digital Strategy and Business Development, NBC Universal. Board: World
Wide Biggies.

HOUSE_OVERSIGHT_013487
